1 1 1 1 1 1 1 1 1 1 4
1 0 0 0 0 0 0 0 0 0 4
1 0 0 0 0 0 0 0 0 0 4
1 0 0 0 0 0 0 0 0 0 4
1 2 2 2 2 2 2 2 2 2 2